1111111111111111111111111
1000000000110000000000001
101100000111000000000000
10010000000100000N0000001
1111011111010101111010001
1111111111111111111111111