1111111111
1000100001
1100000111
10P0000001
1000110001
1000000E01
1011000001
10000001N1
1000000111
1111111111