1111111111111111111111111
1000000000110000000000001
1011000001110000000000001
1001000000000000000000001
1100000111010101111000111
1111011111010101111010001
1111111111111111111111111