NO walls/NO.xpm
EA walls/EA.xpm
SO walls/SO.xpm
WE walls/WE.xpm

F 34,139,34

C 135,206,235

   1111111111111111111111111
1000000000000001100000010001
1000000000000001101010010001
11000010101011111011110N0111
111101111110101 101111010001
111111111111111 111111111111


